######################
#A          #       ##
# ### ####### ##### ##
#   #     #       # ##
# ##### ### ####### ##
#     #           # ##
# # ##### ### ### ####
# #   # #   # # #   ##
# ##### ####### ### ##
#         #       # ##
# ### # # # ##### # ##
#   # # #       # # ##
# ### # ### # # ### ##
#   # #   # # # #   ##
# # # # ##############
# # # #         # # ##
# # ### ####### # # ##
# # # #       #     ##
# ### ########### ####
#               #  B##
######################